Date,Team,Possession ,Shots,On target,Off target,Goals Scored,Goals Against
8/9/2014,Austria ,56,10,5,5,1,1
9/10/2014,Austria ,61,10,8,2,2,1
12/10/2014,Austria ,55,14,8,6,1,0
15/11/2014,Austria ,47,7,4,3,1,0
27/3/2015,Austria ,62,14,6,8,5,0
14/6/2015,Austria ,44,11,5,6,1,0
5/9/2015,Austria ,62,18,8,10,1,0
8/9/2015,Austria ,47,14,12,2,4,1
9/10/2015,Austria ,61,19,11,8,3,2
12/10/2015,Austria ,60,28,14,14,3,0
