Date,Team,Possession ,Shots,On target,Off target,Goals Scored,Goals Against
8/9/2014,England ,46,11,5,6,2,0
9/10/2014,England ,70,21,16,5,5,0
12/10/2014,England ,70,13,5,8,1,0
15/11/2014,England ,58,12,6,6,3,1
27/3/2015,England ,64,19,11,8,4,0
14/6/2015,England ,56,12,6,6,3,2
5/9/2015,England ,69,16,9,7,6,0
8/9/2015,England ,49,11,7,4,2,0
9/10/2015,England ,61,18,8,10,2,0
12/10/2015,England ,59,18,12,6,3,0
